7 12
|----------|
|@..|P.-...|	 
|..-|.C....|
|.@....-@.-|
|-..|......|
|.....|.-.@|	
|----------|


